111111
10CE11
1PCC11
111011
1C1111
111111