1111111111
1010000E11
1P10000C11
1110000011
1C10000111
1111111111