11111111111111111111111111111111
10000000000000000000000000000001
10111011111011011111011011111001
1010P000000001000000001000000001
10101111001001111101001111001001
10101000001001000001001000001CC1
10101011101001011101001011101CC1
1000101000100CCC0001000001E01CC1
10111010101111001101111011101001
10100000100000000M00000000000001
10101111111111111101111111111101
10000000000000000000000000001CC1
11111111111111111111111111111111