111111111111111111111111111111111111111111111111
1CCCCC0P0CCCCCCC11111111111111111111111111111111
1C111110111CCCCCCCCC1111110001111111110111111111
1C1CCC1C111C11111C111111111111111111111111111111
1C111C1C111C1111CCCCCCCCC11111111111111111111111
1C111C1C111C1111CC111111C11111111111111111111111
1CCCCC1C111CCCCCCCCCCCCCC11111111110111111111111
1111111C111111111C111111C11111111111111111111111
1111111C1CCCCCCCCC11111CCCCCCCCCCCCCCCCCCCCCCCC1
1CCCCC1C111C11111C11111C11CCCCCCCCCCCCCCCCCCCCC1
1C111C1CCC1111111C11111CC1CCCCCCCCCCCCCCCCCCCCC1
1C111C1C1CCCCCCCCCCCCCCCCCCCCCCCCCCCCCCCCCCCCCC1
1C111C1C111111111C11111CC1CCCC1CCCCCCCCCCCCCCCC1
1C111C1CCC000CCCCC11111CC1CCCCCCCCCCCCCCCCCCCCC1
1C1ECC1C111C11111C111111C1CCCCCCCCCCCCCCCCCCCCC1
1C11111C111CCCCCCCCCCCCCC1CCCCCCCCCCCCCCCCCCCCC1
1CCCCCCCCCC11111C11111CCCCCCCC1CCCCCCCCCCCCCCCC1
100011111110000000000000000000000000000000000001
100000000000000000000000000000000000000000000001
100000000000000000000000000000000000000000000001
100000000000000000000000000000000000000000000001
100000000000000000000000000000000000000000000001
100000000000000000000000000000000000000000000001
100000000000000000000000000000000000000000000001
100000000000000000000000000000000000000000000001
111111111111111111111111111111111111111111111111